TILEMAP
36 28 							-- Size of tile map in tiles
16 16 							-- Tile size & block size
images/Lava_tileset.png 	-- Tilesheet
8 11 								-- Number of tiles in tilesheet
10,11,13,13,14,1,1,1,1,1,1,1,1,1,1,1,1,1,1,1,1,1,1,1,1,1,1,1,1,1,1,1,1,1,1,1,
1,1, , , , , , , , , , , , , , , , , , , , , , , , , , , , , , , , ,1,1,
1,1, , , , , , , , , , , , , , , , , , , , , , , , , , , , , , , , ,1,1,
1,1, , , , , , , , , , , , , , , , , , , , , , , , , , , , , , , , ,1,1,
1,1, , , , , , , , , , , , , , , , , , , , , , , , , , , , , , , , ,1,1,
1,1, , , , , , , , , , , , , , , , , , , , , , , , , , , , , , , , ,1,1,
1,1, , , , , , , , , , , , , , , , , , , , , , , , , , , , , , , , ,1,1,
1,1,1,1, , , ,1,1,1,1,1, , , ,1, , , ,1, , , ,1,1,1,1,1,1, , , ,1,1,1,1,
1,1, , , , , , , , , , , ,1, ,1, ,1, ,1, ,1, , , , , , , , , , , , ,1,1,
1,1, , , , , , , , , , , , , , , , , , , , , , , , , , , , , , , , ,1,1,
1,1, , , , , , , , , , , , , , , , , , , , , , , , , , , , , , , , ,1,1,
1,1, , , , , , , , , , , , , , , , , , , , , , , , , , , , , , , , ,1,1,
1,1,1,1, , , ,1,1,1,1, , , ,3,3, , , ,4,4, , , ,1,1,1,1,1, , , ,1,1,1,1,
1,1, , , , , , , , , , , , , , , , , , , , , , , , , , , , , , , , ,1,1,
1,1, , , , , , , , , , , , , , , , , , , , , , , , , , , , , , , , ,1,1,
1,1, , , , , , , , , , , , , , ,1,1,1, , , , , , , , , , , , , , , ,1,1,
1,1, , , , , , , , , , , , , , , , , , , , , , , , , , , , , , , , ,1,1,
1,1,1,1, , , ,1,1,1, , ,2,2, , , , , , , ,2,2, , ,1,1,1,1, , , ,1,1,1,1,
1,1, , , , , , , , , , , , ,2,2, , , ,2,2, , , , , , , , , , , , , ,1,1,
1,1, , , , , , , , , , , , , ,2,2,2,2,2, , , , , , , , , , , , , , ,1,1,
1,1, , , , , , , , , , , , , , , , , , , , , , , , , , , , , , , , ,1,1,
1,1, , , , , , , , , , , , , , , , , , , , , , , , , , , , , , , , ,1,1,
1,1,1,1, , , ,1,1,1,1,1,1,1,1,1,1,1,1,1,1,1,1,1,1,1,1,1,1, , , ,1,1,1,1,
1,1, , , , , , , , , , , , , , , , , , , , , , , , , , , , , , , , ,1,1,
1,1, , , , , , , , , , , , , , , , , , , , , , , , , , , , , , , , ,1,1,
1,1, , , , , , , , , , , , , , , , , , , , , , , , , , , , , , , , ,1,1,
1,1, , , , , , , , , , , , , , , , , , , , , , , , , , , , , , , , ,1,1,
1,1,1,1,1,1,1,1,1,1,1,1,1,1,1,1,1,1,1,1,1,1,1,1,1,1,1,1,1,1,1,1,1,1,1,1,

